16
20
00000000000000000000
00000000000000000000
00000000000000000000
00000000000000011100
00000000000000000000
00001111100000000000
00000000000000000000
00000000001100100000
00000000001100100011
11110000001100100011
11110002220022000011
11110001111111122211
11010001111111111111
10010000111111100011
00010000011111100011
00010000001111000011