16
20
11111111111111111111
11111111111111111111
11000000000000000011
10000000000000000001
00000000000000000000
00000000000000000000
00000011111111000000
00000111111111100000
00000000000000000000
00000000000000000000
11111000000000011111
00000000000000000000
00000000000000000000
00111111111111111100
00111111111111111100
00000000000000000000